*************************************
              ** ******             *
** ******* ** **        ****** ******
**   ***** ** ** *************      *
**** *********** ********      *** **
****                      ** * *** **
**** *********************** *     **
*    ************************* ******
**** ***                     *     **
**** *** ** * ** ****** * ** * ******
*    *** ** * ** ****** * ** * ******
* ** *** ** * ****      * ** *      *
* ** *** ************** * ** * **** *
*                  ** * ****** **** *
**** *** *** ***** ** *      * **** *
**** *** *** ***** ** * ********    *
*    ******* ***** ** *      ****** *
********************* * **** ****** *
*****                   ** *     ** *
***** ** *** ***** **** ** * ****** *
*     ** *** ***** ** * ** * ********
** ** ** *** ***** ** * ** *      ***
** ** ** ***    ** ** **** * ********
******** ************ **** * ********
**       ********                    
*************************************